TILEMAP
26 8 							-- Size of tile map in tiles
32 63 32 63						-- Tile size & block size
images/mapa.png	            			-- Tilesheet
130 12							-- Number of tiles in tilesheet 
52 53 54 52 53 54 52 52 53 54 55 56 57 58 55 767 767 767 767 767 767 767 767 767 768 769 
18 1 14 14 14 52 53 54 55 56 57 58 53 54 637 637 637 637 901 902 903 904 905 906 907 908 
18 131 132 133 134 535 536 537 561 539 540 141 574 584 1023 1023 1023 1023 1031 1032 1033 1034 1035 1036 1037 1038 
18 261 262 663 664 665 405 405 405 405 405 405 317 317 317 317 317 317 630 630 630 630 630 630 630 630 
18 391 392 793 794 795 405 405 405 405 405 405 317 317 317 317 317 317 630 630 630 630 630 630 630 630 
18 521 522 923 924 925 405 901 15 16 907 405 317 317 317 317 317 317 630 630 630 630 630 630 630 630 
18 18 18 1053 1054 1054 561 1031 145 146 1037 405 317 317 317 317 317 317 630 630 630 630 630 630 630 630 
18 18 18 18 18 18 18 18 18 18 18 18 317 317 317 317 317 317 630 630 630 630 630 630 630 630