TILEMAP
41 10 							-- Size of tile map in tiles
32 63 32 63						-- Tile size & block size
images/Palace.png	            			-- Tilesheet
90 15						    -- Number of tiles in tilesheet 
16                               -- offset
467 468 469 470 471 472 473 474 475 476 476 476 476 476 476 476 476 476 476 476 476 476 476 476 476 476 476 476 476 476 476 476 476 476 476 918 918 918 918 918 918 
557 559 560 561 562 558 559 560 566 557 923 385 385 385 385 385 385 385 385 385 385 385 385 385 385 385 385 385 385 385 385 385 385 385 385 385 918 918 918 918 918 
647 649 649 651 652 654 654 654 616 654 446 442 442 442 442 442 442 442 442 442 441 441 441 441 441 441 441 441 660 660 660 660 660 660 660 385 918 918 918 918 918 
540 540 537 538 539 540 541 748 748 748 749 442 526 567 574 575 574 575 576 577 576 577 578 606 607 361 362 363 364 365 466 466 918 918 918 918 918 918 918 918 918 
1015 1015 1015 1015 1015 1015 1015 1107 1107 748 542 447 367 447 664 447 664 447 666 667 666 667 668 684 684 451 452 453 454 455 466 466 918 918 918 918 918 918 918 918 918 
1015 1015 1015 1015 1015 1015 1015 1015 1015 748 748 748 748 748 748 748 748 748 748 748 776 776 776 776 776 541 542 543 544 545 466 466 918 918 918 918 918 918 918 918 918 
1015 1015 1015 1015 1015 1015 1015 1015 1015 529 530 168 168 529 530 183 183 427 428 429 169 169 715 716 169 631 632 633 634 635 466 466 918 918 918 918 918 918 918 918 918 
1015 1015 1015 1015 1015 1015 1015 1015 1015 529 710 711 712 529 710 183 183 517 518 519 698 698 698 446 447 450 450 628 629 361 466 466 918 918 918 918 918 918 918 918 918 
1015 1015 1015 1015 1015 1015 1015 1015 940 619 800 651 652 619 800 654 654 341 432 654 654 654 654 654 654 654 627 628 719 466 466 466 918 918 918 918 918 918 918 918 918 
918 918 918 918 918 918 918 918 918 918 918 918 918 918 918 918 918 918 918 918 918 918 918 918 918 918 918 918 918 918 918 918 918 918 918 918 918 918 918 918 918
