TILEMAP
20 5 							-- Size of tile map in tiles
16 32 32 32						-- Tile size & block size
images/level01.jpg	            			-- Tilesheet
80 11							-- Number of tiles in tilesheet
437 438 439 440 441 442 443 444 445 446 447 448 449 450 451 452 453 454 455 456 
517 518 519 520 521 522 523 524 525 526 527 528 529 530 531 532 533 534 535 536 
597 598 599 600 601 602 603 604 605 606 607 608 609 610 611 612 613 614 615 616 
677 678 679 680 681 682 683 684 685 686 687 688 689 680 681 697 697 694 698 699 
50 51 52 53 54 55 56 50 51 52 53 54 55 56 57 58 59 60 61 62 
