TILEMAP
41 10 							-- Size of tile map in tiles
32 63 32 63						-- Tile size & block size
images/mapa.png	            			-- Tilesheet
130 12							-- Number of tiles in tilesheet 
8                               -- offset 
418 26 671 811 22 811 811 418 418 418 28 29 29 29 29 671 883 882 884 157 563 319 554 173 434 435 445 445 177 177 177 177 177 176 177 177 36 36 36 177 0 
19 20 21 22 23 24 25 26 27 18 28 29 29 29 29 21 752 883 884 157 173 557 557 173 564 565 557 557 557 173 574 36 36 177 176 177 177 177 36 176 0 
149 150 151 158 153 154 288 156 157 148 157 158 158 288 289 290 296 297 753 623 425 182 182 54 182 54 182 182 54 425 1154 1017 888 573 1017 1022 573 574 36 177 0 
537 537 537 537 537 537 537 537 670 704 705 909 910 911 23 24 914 915 910 246 413 633 635 414 414 414 49 49 49 49 312 312 312 312 312 312 29 21 167 176 0 
1051 1051 1051 1051 1051 1051 1051 1051 800 834 1161 1039 1040 552 153 154 552 1045 1040 285 156 157 1157 410 411 282 893 894 65 325 897 897 897 460 511 511 446 290 174 174 0 
1051 1051 1051 1051 1051 1051 1051 1051 930 1176 805 805 805 805 805 805 805 805 805 805 540 544 546 410 544 449 1023 1021 1026 1032 1026 573 320 586 573 1034 697 697 697 697 0 
1051 1051 1051 1051 1051 1051 1051 1052 1052 1051 1051 1051 1051 1051 1051 1051 1051 1051 1051 1051 1051 1051 1051 1051 1051 1051 1051 1051 1051 1051 1051 1051 1051 1051 1051 1051 1051 1051 1051 1051 0 
1051 1439 1440 1441 1442 1443 1444 1445 1051 1051 1051 1051 1051 1051 1051 1051 1051 1051 1051 1051 1051 1051 1051 1051 1051 1051 1051 1051 1051 1051 1051 1051 1051 1051 1051 1051 1051 1051 1051 1051 0 
1051 1051 1051 1051 1051 1051 1051 1051 1051 1051 1051 1051 1051 1051 1051 1051 1051 1051 1051 1051 1051 1051 1051 1051 1051 1051 1051 1051 1051 1051 1051 1051 1051 1051 1051 1051 1051 1051 1051 1051 0 
0 0 0 0 0 0 0 0 0 0 0 0 0 0 0 0 0 0 0 0 0 0 0 0 0 0 0 0 0 0 0 0 0 0 0 0 0 0 0 0 0