TILEMAP
26 9 							-- Size of tile map in tiles
32 63 32 63						-- Tile size & block size
images/mapa.png	            			-- Tilesheet
130 12							-- Number of tiles in tilesheet 
0                               -- offset
669 669 669 669 669 669 669 669 669 669 669 669 669 669 669 767 767 767 767 767 767 767 767 767 768 769 
669 1 14 14 14 669 669 669 669 669 669 669 669 669 8 637 637 637 901 902 903 904 905 906 907 908 
669 131 132 133 134 535 536 537 561 539 426 141 574 584 1023 1023 1023 1023 1031 1032 1033 1034 1035 1036 1037 1038 
669 261 669 663 664 669 669 669 669 669 669 669 669 669 669 669 669 669 669 669 669 669 669 669 669 630 
669 669 669 793 794 669 669 669 669 669 669 669 669 669 669 669 669 669 669 669 669 669 669 669 669 669 
7 7 7 663 664 527 527 527 527 527 527 527 527 527 527 527 527 527 527 527 527 527 527 527 527 527 
669 669 669 923 924 669 669 901 15 16 907 456 275 399 458 458 458 458 458 458 458 458 458 458 458 669 
669 669 669 1053 1054 1054 561 1031 145 146 1037 458 278 722 458 458 458 458 458 458 458 458 458 458 458 714 
669 669 669 669 669 669 669 669 669 669 669 669 669 669 669 669 669 669 669 669 669 669 669 669 669 669