TILEMAP
40 8 							-- Size of tile map in tiles
32 63 32 63						-- Tile size & block size
images/mapa.png	            			-- Tilesheet
130 12							-- Number of tiles in tilesheet 
0                               -- offset
15 16 17 18 19 20 21 22 23 24 25 26 27 28 29 30 420 420 420 420 294 637 638 637 638 639 640 641 642 633 371 372 373 633 633 633 633 0 0 0 
145 146 280 148 149 606 150 148 149 153 153 156 157 158 159 160 420 420 420 420 892 637 638 639 640 641 642 642 633 633 372 373 374 633 633 633 633 0 0 0 
664 535 536 278 279 280 281 282 283 284 285 286 287 606 289 1028 1154 1155 1416 1417 613 899 900 901 902 903 904 905 906 907 908 633 633 633 633 633 633 0 0 0 
288 541 542 543 544 545 546 547 548 549 550 551 552 553 554 555 556 557 558 402 1016 465 466 1031 1032 1033 1034 1035 1036 1037 1038 633 633 633 633 633 633 0 0 0 
699 699 699 699 699 699 699 699 699 699 699 699 699 699 699 699 699 699 699 699 696 697 698 699 699 699 699 699 0 0 0 633 633 633 633 633 633 0 0 0 
699 699 699 699 699 699 699 699 699 699 699 699 699 699 699 699 699 699 699 699 826 827 828 699 699 699 699 699 0 0 0 633 633 633 633 633 633 0 0 0 
699 699 699 699 699 699 699 699 699 699 699 699 699 699 699 699 699 699 699 26 27 957 958 699 699 699 699 699 0 0 0 633 633 633 633 633 633 0 0 0 
597 727 546 547 548 545 546 547 548 544 545 546 547 548 546 547 548 547 548 156 287 1087 1088 699 699 699 699 699 0 0 0 633 633 633 633 633 633 0 0 0